1.400000000000000000e+01
1.600000000000000000e+01
2.000000000000000000e+00
1.600000000000000000e+01
1.400000000000000000e+01
1.500000000000000000e+01
9.000000000000000000e+00
1.500000000000000000e+01
1.600000000000000000e+01
1.600000000000000000e+01
1.400000000000000000e+01
9.000000000000000000e+00
9.000000000000000000e+00
1.600000000000000000e+01
1.400000000000000000e+01
9.000000000000000000e+00
1.500000000000000000e+01
1.400000000000000000e+01
1.500000000000000000e+01
9.000000000000000000e+00
1.600000000000000000e+01
6.000000000000000000e+00
6.000000000000000000e+00
9.000000000000000000e+00
9.000000000000000000e+00
1.600000000000000000e+01
9.000000000000000000e+00
3.000000000000000000e+00
9.000000000000000000e+00
1.600000000000000000e+01
1.000000000000000000e+00
4.000000000000000000e+00
1.600000000000000000e+01
9.000000000000000000e+00
1.400000000000000000e+01
1.500000000000000000e+01
3.000000000000000000e+00
1.600000000000000000e+01
1.600000000000000000e+01
9.000000000000000000e+00
1.600000000000000000e+01
1.600000000000000000e+01
1.400000000000000000e+01
9.000000000000000000e+00
