0.000000000000000000e+00
1.900000000000000000e+01
2.000000000000000000e+00
6.000000000000000000e+00
1.900000000000000000e+01
1.900000000000000000e+01
6.000000000000000000e+00
1.900000000000000000e+01
1.100000000000000000e+01
1.100000000000000000e+01
1.100000000000000000e+01
6.000000000000000000e+00
6.000000000000000000e+00
1.900000000000000000e+01
1.800000000000000000e+01
1.800000000000000000e+01
9.000000000000000000e+00
6.000000000000000000e+00
6.000000000000000000e+00
1.800000000000000000e+01
6.000000000000000000e+00
6.000000000000000000e+00
1.800000000000000000e+01
1.200000000000000000e+01
1.700000000000000000e+01
1.000000000000000000e+01
6.000000000000000000e+00
9.000000000000000000e+00
1.800000000000000000e+01
6.000000000000000000e+00
1.800000000000000000e+01
0.000000000000000000e+00
1.100000000000000000e+01
9.000000000000000000e+00
1.900000000000000000e+01
1.100000000000000000e+01
1.800000000000000000e+01
6.000000000000000000e+00
1.800000000000000000e+01
1.900000000000000000e+01
1.900000000000000000e+01
1.800000000000000000e+01
0.000000000000000000e+00
0.000000000000000000e+00
1.900000000000000000e+01
1.900000000000000000e+01
1.900000000000000000e+01
6.000000000000000000e+00
3.000000000000000000e+00
1.100000000000000000e+01
1.100000000000000000e+01
0.000000000000000000e+00
6.000000000000000000e+00
1.700000000000000000e+01
1.100000000000000000e+01
0.000000000000000000e+00
